{
  "x_axis": 6,
  "y_axis": 2,
  "z_axis": 6,
  "level_map": [
    [
      [1, 1, 1, 1, 1, 1],
      [1, 1, 1, 1, 1, 1],
      [1, 1, 1, 1, 1, 1],
      [1, 1, 1, 1, 1, 1],
      [1, 1, 1, 1, 1, 1],
      [1, 1, 1, 1, 1, 1]
    ],

    [
      [0, 0, 0, 0, 0, 0],
      [0, 0, 0, 0, 0, 0],
      [0, 0, 0, 0, 0, 0],
      [0, 0, 0, 0, 0, 0],
      [0, 2, 2, 0, 0, 0],
      [1, 0, 0, 0, 0, 0]
    ]
  ]
}
