6,2,6

1,1,1,1,1,1
1,1,1,1,1,1
1,1,1,1,1,1
1,1,1,1,1,1
1,1,1,1,1,1
1,1,1,1,1,1

3,3,3,3,3,3
3,0,0,0,0,3
3,0,0,0,0,3
3,0,0,0,0,3
3,2,2,0,0,3
3,3,3,3,3,3