6,2,6

1,1,1,1,1,1
1,1,1,1,1,1
1,1,1,1,1,1
1,1,1,1,1,1
1,1,1,1,1,1
1,1,1,1,1,1

0,0,0,0,0,0
0,0,0,0,0,0
0,0,0,1,0,0
0,0,4,0,0,0
0,0,3,4,0,0
1,2,0,0,0,0